#####################
#P        #      p# #
# ### # # # ##### # #
# #   # #     #   # #
# # ### ##### # ### #
#   #   #   # #     #
# ### ### # # ##### #
#   #   # #     #   #
# # ### # # ### ### #
# #         # i #   #
# ####### ### ### # #
# #       #     # # #
  # # # # # ### # #  
#   # # # c   # # # #
# ### ### ### ### # #
#     #   #   #   # #
##### ### # ### # ###
#   #     #     #   #
# # # ######### ### #
# # #   #     #     #
# ### ### ### ### ###
#   # b   #   #     #
### ##### # ### ### #
#         #         #
#####################
